"filename", "language", "Markdown", "Python", "JSON", "LaTeX", "comment", "blank", "total"
"c:\Users\AMILCAR\Documents\GitHub\MilcaStructures\README.md", "Markdown", 457, 0, 0, 0, 0, 151, 608
"c:\Users\AMILCAR\Documents\GitHub\MilcaStructures\examples\1_armadura_sencilla.py", "Python", 0, 26, 0, 0, 0, 11, 37
"c:\Users\AMILCAR\Documents\GitHub\MilcaStructures\examples\3_portico_2_aguas.py", "Python", 0, 20, 0, 0, 1, 9, 30
"c:\Users\AMILCAR\Documents\GitHub\MilcaStructures\examples\3_portico_3_niveles copy.py", "Python", 0, 35, 0, 0, 3, 11, 49
"c:\Users\AMILCAR\Documents\GitHub\MilcaStructures\examples\3_portico_3_niveles.py", "Python", 0, 34, 0, 0, 0, 10, 44
"c:\Users\AMILCAR\Documents\GitHub\MilcaStructures\examples\4.1_muro_alba.py", "Python", 0, 26, 0, 0, 0, 5, 31
"c:\Users\AMILCAR\Documents\GitHub\MilcaStructures\examples\4.2_portico_inclinado_brazo.py", "Python", 0, 37, 0, 0, 0, 5, 42
"c:\Users\AMILCAR\Documents\GitHub\MilcaStructures\examples\4.3_aguas_model.py", "Python", 0, 22, 0, 0, 0, 9, 31
"c:\Users\AMILCAR\Documents\GitHub\MilcaStructures\examples\4_portico_2_aguas_v2.py", "Python", 0, 21, 0, 0, 1, 9, 31
"c:\Users\AMILCAR\Documents\GitHub\MilcaStructures\examples\5_asentamientos.py", "Python", 0, 17, 0, 0, 7, 3, 27
"c:\Users\AMILCAR\Documents\GitHub\MilcaStructures\examples\6_elastic_suports.py", "Python", 0, 21, 0, 0, 0, 6, 27
"c:\Users\AMILCAR\Documents\GitHub\MilcaStructures\examples\MODELOS.py", "Python", 0, 208, 0, 0, 40, 61, 309
"c:\Users\AMILCAR\Documents\GitHub\MilcaStructures\examples\WallPortal_MQ6.py", "Python", 0, 48, 0, 0, 3, 8, 59
"c:\Users\AMILCAR\Documents\GitHub\MilcaStructures\examples\WallPortal_MQ6I.py", "Python", 0, 48, 0, 0, 3, 8, 59
"c:\Users\AMILCAR\Documents\GitHub\MilcaStructures\examples\WallPortal_MQ6IMod.py", "Python", 0, 48, 0, 0, 0, 8, 56
"c:\Users\AMILCAR\Documents\GitHub\MilcaStructures\examples\WallPortal_Offset.py", "Python", 0, 41, 0, 0, 0, 8, 49
"c:\Users\AMILCAR\Documents\GitHub\MilcaStructures\examples\WallPortal_cst.py", "Python", 0, 54, 0, 0, 0, 5, 59
"c:\Users\AMILCAR\Documents\GitHub\MilcaStructures\examples\beamCSI.py", "Python", 0, 33, 0, 0, 0, 11, 44
"c:\Users\AMILCAR\Documents\GitHub\MilcaStructures\examples\end_length_offset.py", "Python", 0, 195, 0, 0, 33, 47, 275
"c:\Users\AMILCAR\Documents\GitHub\MilcaStructures\examples\local_axis_node.py", "Python", 0, 28, 0, 0, 7, 0, 35
"c:\Users\AMILCAR\Documents\GitHub\MilcaStructures\examples\portal.py", "Python", 0, 38, 0, 0, 0, 15, 53
"c:\Users\AMILCAR\Documents\GitHub\MilcaStructures\examples\portal3_releases.py", "Python", 0, 37, 0, 0, 0, 11, 48
"c:\Users\AMILCAR\Documents\GitHub\MilcaStructures\examples\releases.ipynb", "JSON", 0, 0, 907, 0, 0, 1, 908
"c:\Users\AMILCAR\Documents\GitHub\MilcaStructures\examples\suport_k.py", "Python", 0, 35, 0, 0, 1, 1, 37
"c:\Users\AMILCAR\Documents\GitHub\MilcaStructures\examples\testMembQ6 copy.py", "Python", 0, 22, 0, 0, 0, 5, 27
"c:\Users\AMILCAR\Documents\GitHub\MilcaStructures\examples\testMembQ6.py", "Python", 0, 22, 0, 0, 0, 5, 27
"c:\Users\AMILCAR\Documents\GitHub\MilcaStructures\milcapy\__init__.py", "Python", 0, 27, 0, 0, 0, 4, 31
"c:\Users\AMILCAR\Documents\GitHub\MilcaStructures\milcapy\analysis\linear_static.py", "Python", 0, 221, 0, 0, 72, 77, 370
"c:\Users\AMILCAR\Documents\GitHub\MilcaStructures\milcapy\analysis\manager.py", "Python", 0, 68, 0, 0, 10, 18, 96
"c:\Users\AMILCAR\Documents\GitHub\MilcaStructures\milcapy\core\node.py", "Python", 0, 71, 0, 0, 6, 17, 94
"c:\Users\AMILCAR\Documents\GitHub\MilcaStructures\milcapy\core\results.py", "Python", 0, 162, 0, 0, 0, 57, 219
"c:\Users\AMILCAR\Documents\GitHub\MilcaStructures\milcapy\elements\CST.py", "Python", 0, 104, 0, 0, 0, 18, 122
"c:\Users\AMILCAR\Documents\GitHub\MilcaStructures\milcapy\elements\MQ6.py", "Python", 0, 277, 0, 0, 5, 48, 330
"c:\Users\AMILCAR\Documents\GitHub\MilcaStructures\milcapy\elements\MQ6I.py", "Python", 0, 211, 0, 0, 9, 26, 246
"c:\Users\AMILCAR\Documents\GitHub\MilcaStructures\milcapy\elements\MQ6IMod.py", "Python", 0, 32, 0, 0, 4, 4, 40
"c:\Users\AMILCAR\Documents\GitHub\MilcaStructures\milcapy\elements\member.py", "Python", 0, 319, 0, 0, 9, 62, 390
"c:\Users\AMILCAR\Documents\GitHub\MilcaStructures\milcapy\elements\truss.py", "Python", 0, 52, 0, 0, 0, 8, 60
"c:\Users\AMILCAR\Documents\GitHub\MilcaStructures\milcapy\loads\__init__.py", "Python", 0, 7, 0, 0, 0, 2, 9
"c:\Users\AMILCAR\Documents\GitHub\MilcaStructures\milcapy\loads\load.py", "Python", 0, 961, 0, 0, 1, 139, 1101
"c:\Users\AMILCAR\Documents\GitHub\MilcaStructures\milcapy\loads\load_pattern.py", "Python", 0, 357, 0, 0, 0, 61, 418
"c:\Users\AMILCAR\Documents\GitHub\MilcaStructures\milcapy\material\material.py", "Python", 0, 54, 0, 0, 0, 15, 69
"c:\Users\AMILCAR\Documents\GitHub\MilcaStructures\milcapy\model\model.py", "Python", 0, 1206, 0, 0, 45, 219, 1470
"c:\Users\AMILCAR\Documents\GitHub\MilcaStructures\milcapy\plotter\UIdisplay.py", "Python", 0, 705, 0, 0, 53, 129, 887
"c:\Users\AMILCAR\Documents\GitHub\MilcaStructures\milcapy\plotter\load.py", "Python", 0, 273, 0, 0, 104, 70, 447
"c:\Users\AMILCAR\Documents\GitHub\MilcaStructures\milcapy\plotter\options.py", "Python", 0, 322, 0, 0, 29, 47, 398
"c:\Users\AMILCAR\Documents\GitHub\MilcaStructures\milcapy\plotter\plotter copy 2.py", "Python", 0, 1499, 0, 0, 114, 267, 1880
"c:\Users\AMILCAR\Documents\GitHub\MilcaStructures\milcapy\plotter\plotter copy.py", "Python", 0, 1500, 0, 0, 114, 267, 1881
"c:\Users\AMILCAR\Documents\GitHub\MilcaStructures\milcapy\plotter\plotter.py", "Python", 0, 1499, 0, 0, 114, 267, 1880
"c:\Users\AMILCAR\Documents\GitHub\MilcaStructures\milcapy\plotter\plotter_values.py", "Python", 0, 154, 0, 0, 10, 33, 197
"c:\Users\AMILCAR\Documents\GitHub\MilcaStructures\milcapy\plotter\suports.py", "Python", 0, 282, 0, 0, 10, 31, 323
"c:\Users\AMILCAR\Documents\GitHub\MilcaStructures\milcapy\plotter\utils.py", "Python", 0, 78, 0, 0, 6, 20, 104
"c:\Users\AMILCAR\Documents\GitHub\MilcaStructures\milcapy\plotter\widgets.py", "Python", 0, 390, 0, 0, 60, 116, 566
"c:\Users\AMILCAR\Documents\GitHub\MilcaStructures\milcapy\postprocess\CST_pp.py", "Python", 0, 44, 0, 0, 0, 11, 55
"c:\Users\AMILCAR\Documents\GitHub\MilcaStructures\milcapy\postprocess\membranebQ6.py", "Python", 0, 1, 0, 0, 0, 7, 8
"c:\Users\AMILCAR\Documents\GitHub\MilcaStructures\milcapy\postprocess\post_processing.py", "Python", 0, 141, 0, 0, 7, 35, 183
"c:\Users\AMILCAR\Documents\GitHub\MilcaStructures\milcapy\postprocess\segment_member.py", "Python", 0, 270, 0, 0, 26, 71, 367
"c:\Users\AMILCAR\Documents\GitHub\MilcaStructures\milcapy\report\cap1.tex", "LaTeX", 0, 0, 0, 117, 0, 16, 133
"c:\Users\AMILCAR\Documents\GitHub\MilcaStructures\milcapy\report\cap2.tex", "LaTeX", 0, 0, 0, 29, 0, 13, 42
"c:\Users\AMILCAR\Documents\GitHub\MilcaStructures\milcapy\report\main.tex", "LaTeX", 0, 0, 0, 61, 30, 23, 114
"c:\Users\AMILCAR\Documents\GitHub\MilcaStructures\milcapy\report\report.py", "Python", 0, 16, 0, 0, 4, 7, 27
"c:\Users\AMILCAR\Documents\GitHub\MilcaStructures\milcapy\section\section.py", "Python", 0, 256, 0, 0, 0, 48, 304
"c:\Users\AMILCAR\Documents\GitHub\MilcaStructures\milcapy\utils\__init__.py", "Python", 0, 21, 0, 0, 0, 4, 25
"c:\Users\AMILCAR\Documents\GitHub\MilcaStructures\milcapy\utils\element.py", "Python", 0, 218, 0, 0, 14, 52, 284
"c:\Users\AMILCAR\Documents\GitHub\MilcaStructures\milcapy\utils\geometry.py", "Python", 0, 78, 0, 0, 0, 28, 106
"c:\Users\AMILCAR\Documents\GitHub\MilcaStructures\milcapy\utils\types.py", "Python", 0, 71, 0, 0, 1, 20, 92
"Total", "-", 457, 13063, 907, 207, 956, 2780, 18370